5,5,9
0,5,0,0,0
1,1,0,0,1
1,0,0,5,1
1,0,0,0,0
1,5,1,1,1