7,7,42
1,0,0,1,0,0,0
0,0,0,0,0,0,0
0,0,1,0,0,0,0
1,0,0,1,0,1,0
0,0,0,0,0,0,1
0,0,0,1,0,0,0
0,0,0,0,0,0,0