9,9,45
1,1,0,0,1,1,0,1,1
1,1,0,0,0,0,1,0,0
0,0,0,0,1,1,0,1,1
1,0,1,0,0,1,1,1,0
0,0,1,0,1,0,1,1,1
0,0,0,1,0,0,1,0,1
1,1,1,0,1,0,1,0,1
1,0,0,1,1,1,1,1,0
0,0,1,0,0,0,0,1,0