7,7,6
5,5,5,1,1,1,1
5,5,1,1,0,1,1
5,1,1,5,0,5,1
1,1,1,0,1,1,1
1,1,5,0,1,1,5
1,1,0,1,1,5,5
1,1,1,1,5,5,5