5,5,7
5,5,1,0,1
5,0,0,0,0
1,0,1,0,1
0,0,0,0,5
1,0,1,5,5