6,5,12
5,1,5,1,5
0,1,1,1,0
0,1,0,1,0
1,1,0,0,0
0,1,0,1,0
0,1,0,0,1