5,5,10
0,5,1,0,5
0,0,0,0,0
0,5,1,0,0
0,0,0,0,0
5,0,1,0,0