7,6,10
1,1,0,1,1,0
1,5,1,0,5,1
0,1,1,1,1,1
0,5,1,1,5,1
0,1,1,1,1,1
1,5,1,1,5,0
1,1,1,1,1,0