5,5,12
5,0,0,1,0
1,5,1,1,0
0,1,1,1,0
1,0,1,5,0
1,0,0,1,0