5,5,6
0,0,0,0,0
0,0,0,0,0
1,0,0,0,1
0,1,0,0,1
0,5,5,5,5