7,7,28
5,1,0,0,0,1,5
1,5,1,0,1,5,1
0,1,5,1,5,1,0
0,0,1,5,1,0,0
0,1,5,1,5,1,0
1,5,1,0,1,5,1
5,1,0,0,0,1,5