3,6,6,39
0,1,1,0,1,1
1,0,1,1,1,1
0,1,0,0,0,0
0,1,1,0,0,0
1,1,0,1,0,0
0,0,0,0,0,0
1,0,1,0,1,0
1,0,1,0,0,1
1,0,0,0,0,1
0,0,0,1,0,0
1,0,1,1,0,0
0,1,1,1,0,0
1,1,1,1,1,1
0,1,0,1,1,0
0,1,0,0,0,1
1,0,1,0,1,1
1,0,1,0,1,0
0,1,0,0,0,1