3,6,6,30
1,0,0,0,1,1
1,1,1,0,0,1
1,0,0,1,1,0
1,0,0,1,0,1
1,0,0,0,1,1
1,0,0,1,0,0
0,1,0,1,0,0
1,0,0,1,0,0
1,0,1,1,0,0
1,1,0,0,1,1
0,1,0,0,0,1
1,0,1,0,0,1
0,0,1,1,0,1
1,0,0,1,1,0
0,0,1,1,0,1
0,0,0,0,1,0
1,1,1,0,1,0
0,1,0,1,1,0